##########
#   #    #
#   #    #
## #### ##
#        #
#        #
##########
