##############
#   #    #   #
#   #    #   #
#   ### ##   #
#            #
#            #
#            #
##############
