############
#   #      #
#   #      #
## #### ####
#          #
#          #
#  #########
#  #  #    #
#          #
############
